##########
#b  X   X#
#P    t  #
#   C    #
#  %     #
#  %  p# #
#  C   #C#
#     O# #
#tmX   #E#
##########
