OOOOOOOOOO
OOOOOOOOOO
##########
#bm% X X #
#  %   # #
#E % C C #
######   #
OOOOO#####
OOOOOOOOOO
OOOOOOOOOO
